111111111111111111
1111000C0E00000111
110011010010010111
100000000000000111
110001110111000111
11000000P010001001
111111111111111111