11111111111111111111111111111
1P010000C100000000000000100E1
11010000010000000000000000001
1000000000000000C000000011111
100000000100000000000000000C1
10000000010000000000000000001
1100000C0000000C0000000000001
11100000000000010000000000001
1111000000000001000000000C001
11111111111111111111111111111