11111111111111111111111111111
1P011000C00000000000111111111
10010000000000000000000000E11
1000000000000000C000000001111
10000000011000000000000000001
10000000011000000000000000001
1000000C0000000C0000110000001
1C00000000000000000011000C001
10000000000000000000000000111
10000000001111000000000001111
10C00000011111100000000111111
11111111111111111111111111111