111111111111111111
11100000000E000001
100000000011111111
100000000000000001
10000011P110000001
1100000000000000C1
111111111111111111