111111111111111111
1111000C0E00000111
110011010010010111
100000000000000111
11111111P111111111
110000001010001001
111111111111111111