1111111111111111111111111111111
10P1000001000000000000000100001
110100000100000000000000000E001
1000000000000000C00000000111111
1000000001000000000000000000001
1000000001000000000000000000011
1000000C0000000C0000000000001C1
1111111111111111111111111111111